ID: 'ID';
IDTip: 'Sequence number of the task';
Description: 'Task';
DescriptionTip: 'Description of the task';
ProceedAt: 'Proceed at';
ProceedAtTip: 'Date and time of proceeding the task';
Priority: 'Priority';
PriorityTip: 'Importance of the task';
AddNewTask: 'Add new task';
Task: 'Task';
AddTask: 'Add task (F1)';
ShowHistory: 'Show history (F2)';
Settings: 'Settings (F3)';
Quit: 'Quit (Alt + F4)';
Restart: 'Restart (F5)';
DBStatusEstablished: 'Connection with database is established.';
DBStatusAbsent: 'Connection with database is not established.';
ServiceApplicationLaunched: 'Application is launched.';
ServiceTasksLoaded: 'Active tasks were uploaded.';
ServiceTaskSaving: 'Task is sending to database.';
ServiceTaskAdded: 'Task is added.';
ServiceTaskNotAdded: 'Task is not added.';
ServiceTaskUpdated: 'Task is updated.';
ServiceTaskRollback: 'Task is not updated.';
ServiceTaskFinished: 'Task is finished.';
ServiceTaskCancelled: 'Task is cancelled.';
TasksHistory: 'History of tasks';
CloseWindow: 'Close window (Esc)';
SettingsWindow: 'Settings';
ChangesNote: 'Changes will come into force after application restart.';
Reset: 'Reset';
OK: 'OK';
Cancel: 'Cancel';
Interface: 'Interface';
Database: 'Database';
Language: 'Language';
Help: 'Help';
LanguageEN: 'English';
LanguageRU: 'Русский';
LaunchingWindowSize: 'Size of main window at launching';
LaunchingWindowSizeMax: 'Maximize';
LaunchingWindowSizeMin: 'Minimize';
ConnectionSettings: 'Connection settings';
Address: 'Address';
Port: 'Port';
DBName: 'Name of database';
DBUsername: 'Username in database';
DBPassword: 'Password';
TimersActivizationMoment: 'Time of timers activization before the event occurs (in minutes)';
Yellow: 'Yellow';
Orange: 'Orange';
Red: 'Red';
Gray: 'Gray';
TimersActivizationNote: '* A negative value of time means the timer will expire after the event occurs.';
PeriodSyncrinizationTime: 'Synchronize with database every (in minutes)';
AboutApplication: 'About application';
Version: 'Version - ';
CurrentVersion: '1.0';
UpdateVersion: '(Update to';
DeveloperPage: 'Developer page';
DBHowToConnect: 'How to configure database connection?';
DBGuide: 'Instruction';
DBVideoguide: 'Video instruction';
Error: 'Error';
DBConnectionFailed: 'Error at database connection. Check connection settings.';
DBCreateTableFailed: 'Failed to create the storage table in database.';
DBCountFailed: 'Error at counting of all the events in database.';
DBUploadFailed: 'Error at uploading of tasks from database.';
DBUploadActiveFailed: 'Error at uploading of active tasks from database.';
DBSaveFailed: 'Error at adding the task into database.';
DBUpdateFailed: 'Error at updating the task in database.';
TaskWrongDescription: 'Description of the task cannot be empty.';
TaskWrongDatetime: 'Ivalid date and time format.';
TaskWrongPriority: 'Unrecognized priority.';
SettingsWrongLanguage: 'Unrecognized language.';
SettingsWrongStartSize: 'Unrecognized value of start screen size.';
SettingsWrongTimerValue: 'Timers cannot contain not-digit values.';
SettingsWrongSyncTime: 'Synchronization time must have only digit value and be not less than 1.';