ID: 'ID';
IDTip: 'Порядковый номер задания';
Description: 'Задание';
DescriptionTip: 'Описание задания';
ProceedAt: 'Выполнить в';
ProceedAtTip: 'Дата и время выполнения задания';
Priority: 'Приоритет';
PriorityTip: 'Важность задания';
AddNewTask: 'Добавить новое задание';
Task: 'Задание';
AddTask: 'Добавить задание (F1)';
ShowHistory: 'Показать историю (F2)';
Settings: 'Настройки (F3)';
Quit: 'Выйти (Alt + F4)';
Restart: 'Перезапустить (F5)';
DBStatusEstablished: 'Соединение с базой данных установлено.';
DBStatusAbsent: 'Соединение с базой данных не установлено.';
ServiceApplicationLaunched: 'Приложение запущено.';
ServiceTasksLoaded: 'Активные задания выгружены.';
ServiceTaskSaving: 'Задание отправляется в базу данных.';
ServiceTaskAdded: 'Задание добавлено.';
ServiceTaskNotAdded: 'Задание не добавлено.';
ServiceTaskUpdated: 'Задание обновлено.';
ServiceTaskRollback: 'Задание не обновлено.';
ServiceTaskFinished: 'Задание завершено.';
ServiceTaskCancelled: 'Задание отменено.';
TasksHistory: 'История заданий';
CloseWindow: 'Закрыть окно (Esc)';
SettingsWindow: 'Настройки';
ChangesNote: 'Изменения вступят в силу после перезапуска приложения.';
Reset: 'Сброс';
OK: 'ОК';
Cancel: 'Отмена';
Interface: 'Интерфейс';
Database: 'База данных';
Help: 'Справка';
Language: 'Язык';
LanguageEN: 'English';
LanguageRU: 'Русский';
LaunchingWindowSize: 'Размер главного окна при запуске';
LaunchingWindowSizeMax: 'Максимальный';
LaunchingWindowSizeMin: 'Минимальный';
ConnectionSettings: 'Настройки соединения';
Address: 'Адрес';
Port: 'Порт';
DBName: 'Имя базы данных';
DBUsername: 'Имя пользователя в базе данных';
DBPassword: 'Пароль';
TimersActivizationMoment: 'Время активизации таймеров до наступления события (минуты)';
Yellow: 'Жёлтый';
Orange: 'Оранжевый';
Red: 'Красный';
Gray: 'Серый';
TimersActivizationNote: '* Отрицательное значение времени означает активизацию таймера после наступления \nсобытия.';
PeriodSyncrinizationTime: 'Синхронизироваться с базой данных каждые \n(в минутах)';
AboutApplication: 'О программе';
Version: 'Версия - ';
CurrentVersion: '1.0';
UpdateVersion: '(Обновить до';
DeveloperPage: 'Страница разработчика';
DBHowToConnect: 'Как настроить соединение с базой данных?';
DBGuide: 'Инструкция';
DBVideoguide: 'Видеоинструкция';
Error: 'Ошибка';
DBConnectionFailed: 'Ошибка подключения к базе данных. Проверьте настройки соединения.';
DBCreateTableFailed: 'Не удалось создать таблицу хранения в базе данных.';
DBCountFailed: 'Ошибка подсчета количества всех заданий в базе данных.';
DBUploadFailed: 'Ошибка выгрузки заданий из базы данных.';
DBUploadActiveFailed: 'Ошибка выгрузки активных заданий из базы данных.';
DBSaveFailed: 'Ошибка добавления задания в базу данных.';
DBUpdateFailed: 'Ошибка обновления задания в базе данных.';
TaskWrongDescription: 'Описание задания не может быть пустым.';
TaskWrongDatetime: 'Неправильный формат даты и времени.';
TaskWrongPriority: 'Нераспознанный приоритет.';
SettingsWrongLanguage: 'Нераспознанный язык.';
SettingsWrongStartSize: 'Нераспознанное значение начального размера экрана.';
SettingsWrongTimerValue: 'Таймеры не должны содержать нечисленные значения.';
SettingsWrongSyncTime: 'Время синхронизации должно иметь численное значение и быть не меньше 1.';